width = 20 
length = 20 
height = 10 
data = [
    1, 3, 3, 3, 3, 3, 3, 4, 3, 3, 3, 1, 3, 3, 3, 3, 3, 3, 3, 3,
    1, 1, 1, 1, 1, 1, 1, 1, 1, 1, 1, 1, 1, 1, 1, 1, 1, 1, 1, 3,
    1, 1, 1, 1, 1, 1, 2, 2, 2, 2, 2, 2, 2, 1, 1, 1, 1, 1, 1, 3,
    1, 1, 1, 0, 0, 0, 1, 1, 1, 1, 2, 1, 2, 1, 1, 1, 1, 1, 1, 3,
    1, 1, 1, 0, 0, 0, 4, 1, 1, 5, 1, 1, 1, 3, 4, 3, 3, 1, 1, 3,
    1, 1, 1, 0, 3, 0, 1, 1, 1, 5, 1, 1, 1, 3, 1, 1, 1, 1, 1, 3,
    1, 1, 1, 0, 3, 0, 1, 1, 1, 1, 1, 1, 1, 3, 1, 1, 1, 1, 1, 3,
    1, 1, 1, 0, 0, 0, 1, 1, 1, 1, 1, 1, 1, 3, 1, 1, 1, 1, 1, 3,
    1, 1, 1, 3, 3, 3, 1, 1, 1, 1, 1, 1, 1, 4, 1, 1, 1, 1, 1, 3,
    1, 1, 1, 1, 1, 1, 1, 1, 1, 1, 1, 1, 1, 3, 3, 3, 3, 3, 3, 3,
    1, 1, 1, 1, 1, 3, 3, 3, 3, 3, 3, 3, 1, 1, 1, 1, 3, 1, 1, 3,
    1, 1, 1, 1, 1, 1, 1, 1, 3, 4, 1, 1, 1, 1, 1, 1, 3, 1, 1, 3,
    1, 1, 1, 1, 1, 1, 1, 1, 3, 5, 1, 1, 1, 1, 1, 1, 1, 1, 1, 1,
    1, 1, 1, 1, 1, 1, 1, 1, 3, 1, 1, 1, 1, 1, 1, 1, 3, 1, 1, 1,
    1, 1, 1, 1, 1, 1, 1, 1, 3, 1, 1, 1, 1, 1, 1, 1, 3, 1, 1, 3,
    1, 1, 1, 1, 1, 1, 1, 1, 1, 1, 1, 3, 3, 3, 3, 1, 3, 3, 3, 3,
    1, 1, 1, 1, 1, 1, 1, 1, 1, 1, 1, 3, 1, 1, 1, 1, 1, 1, 1, 3,
    1, 1, 1, 1, 1, 1, 1, 1, 1, 1, 1, 3, 1, 1, 1, 1, 1, 1, 1, 3,
    1, 1, 1, 1, 1, 1, 1, 1, 1, 1, 1, 3, 1, 1, 1, 1, 1, 1, 1, 3,
    1, 1, 1, 1, 1, 1, 1, 1, 1, 1, 3, 3, 3, 3, 3, 3, 3, 3, 3, 3,
][
    1, 3, 3, 3, 3, 3, 3, 4, 3, 3, 3, 1, 3, 3, 3, 3, 3, 3, 3, 3,
    1, 1, 1, 1, 1, 1, 1, 1, 1, 1, 1, 1, 1, 1, 1, 1, 1, 1, 1, 3,
    1, 1, 1, 1, 1, 1, 2, 2, 2, 2, 2, 2, 2, 1, 1, 1, 1, 1, 1, 3,
    1, 1, 1, 0, 0, 0, 1, 1, 1, 1, 2, 1, 2, 1, 1, 1, 1, 1, 1, 3,
    1, 1, 1, 0, 0, 0, 4, 1, 1, 5, 1, 1, 1, 3, 4, 3, 3, 1, 1, 3,
    1, 1, 1, 0, 3, 0, 1, 1, 1, 5, 1, 1, 1, 3, 1, 1, 1, 1, 1, 3,
    1, 1, 1, 0, 3, 0, 1, 1, 1, 1, 1, 1, 1, 3, 1, 1, 1, 1, 1, 3,
    1, 1, 1, 0, 0, 0, 1, 1, 1, 1, 1, 1, 1, 3, 1, 1, 1, 1, 1, 3,
    1, 1, 1, 3, 3, 3, 1, 1, 1, 1, 1, 1, 1, 4, 1, 1, 1, 1, 1, 3,
    1, 1, 1, 1, 1, 1, 1, 1, 1, 1, 1, 1, 1, 3, 3, 3, 3, 3, 3, 3,
    1, 1, 1, 1, 1, 3, 3, 3, 3, 3, 3, 3, 1, 1, 1, 1, 3, 1, 1, 3,
    1, 1, 1, 1, 1, 1, 1, 1, 3, 4, 1, 1, 1, 1, 1, 1, 3, 1, 1, 3,
    1, 1, 1, 1, 1, 1, 1, 1, 3, 5, 1, 1, 1, 1, 1, 1, 1, 1, 1, 1,
    1, 1, 1, 1, 1, 1, 1, 1, 3, 1, 1, 1, 1, 1, 1, 1, 3, 1, 1, 1,
    1, 1, 1, 1, 1, 1, 1, 1, 3, 1, 1, 1, 1, 1, 1, 1, 3, 1, 1, 3,
    1, 1, 1, 1, 1, 1, 1, 1, 1, 1, 1, 3, 3, 3, 3, 1, 3, 3, 3, 3,
    1, 1, 1, 1, 1, 1, 1, 1, 1, 1, 1, 3, 1, 1, 1, 1, 1, 1, 1, 3,
    1, 1, 1, 1, 1, 1, 1, 1, 1, 1, 1, 3, 1, 1, 1, 1, 1, 1, 1, 3,
    1, 1, 1, 1, 1, 1, 1, 1, 1, 1, 1, 3, 1, 1, 1, 1, 1, 1, 1, 3,
    1, 1, 1, 1, 1, 1, 1, 1, 1, 1, 3, 3, 3, 3, 3, 3, 3, 3, 3, 3,
][
    1, 3, 3, 3, 3, 3, 3, 4, 3, 3, 3, 1, 3, 3, 3, 3, 3, 3, 3, 3,
    1, 1, 1, 1, 1, 1, 1, 1, 1, 1, 1, 1, 1, 1, 1, 1, 1, 1, 1, 3,
    1, 1, 1, 1, 1, 1, 2, 2, 2, 2, 2, 2, 2, 1, 1, 1, 1, 1, 1, 3,
    1, 1, 1, 0, 0, 0, 1, 1, 1, 1, 2, 1, 2, 1, 1, 1, 1, 1, 1, 3,
    1, 1, 1, 0, 0, 0, 4, 1, 1, 5, 1, 1, 1, 3, 4, 3, 3, 1, 1, 3,
    1, 1, 1, 0, 3, 0, 1, 1, 1, 5, 1, 1, 1, 3, 1, 1, 1, 1, 1, 3,
    1, 1, 1, 0, 3, 0, 1, 1, 1, 1, 1, 1, 1, 3, 1, 1, 1, 1, 1, 3,
    1, 1, 1, 0, 0, 0, 1, 1, 1, 1, 1, 1, 1, 3, 1, 1, 1, 1, 1, 3,
    1, 1, 1, 3, 3, 3, 1, 1, 1, 1, 1, 1, 1, 4, 1, 1, 1, 1, 1, 3,
    1, 1, 1, 1, 1, 1, 1, 1, 1, 1, 1, 1, 1, 3, 3, 3, 3, 3, 3, 3,
    1, 1, 1, 1, 1, 3, 3, 3, 3, 3, 3, 3, 1, 1, 1, 1, 3, 1, 1, 3,
    1, 1, 1, 1, 1, 1, 1, 1, 3, 4, 1, 1, 1, 1, 1, 1, 3, 1, 1, 3,
    1, 1, 1, 1, 1, 1, 1, 1, 3, 5, 1, 1, 1, 1, 1, 1, 1, 1, 1, 1,
    1, 1, 1, 1, 1, 1, 1, 1, 3, 1, 1, 1, 1, 1, 1, 1, 3, 1, 1, 1,
    1, 1, 1, 1, 1, 1, 1, 1, 3, 1, 1, 1, 1, 1, 1, 1, 3, 1, 1, 3,
    1, 1, 1, 1, 1, 1, 1, 1, 1, 1, 1, 3, 3, 3, 3, 1, 3, 3, 3, 3,
    1, 1, 1, 1, 1, 1, 1, 1, 1, 1, 1, 3, 1, 1, 1, 1, 1, 1, 1, 3,
    1, 1, 1, 1, 1, 1, 1, 1, 1, 1, 1, 3, 1, 1, 1, 1, 1, 1, 1, 3,
    1, 1, 1, 1, 1, 1, 1, 1, 1, 1, 1, 3, 1, 1, 1, 1, 1, 1, 1, 3,
    1, 1, 1, 1, 1, 1, 1, 1, 1, 1, 3, 3, 3, 3, 3, 3, 3, 3, 3, 3,
][
    1, 3, 3, 3, 3, 3, 3, 4, 3, 3, 3, 1, 3, 3, 3, 3, 3, 3, 3, 3,
    1, 1, 1, 1, 1, 1, 1, 1, 1, 1, 1, 1, 1, 1, 1, 1, 1, 1, 1, 3,
    1, 1, 1, 1, 1, 1, 2, 2, 2, 2, 2, 2, 2, 1, 1, 1, 1, 1, 1, 3,
    1, 1, 1, 0, 0, 0, 1, 1, 1, 1, 2, 1, 2, 1, 1, 1, 1, 1, 1, 3,
    1, 1, 1, 0, 0, 0, 4, 1, 1, 5, 1, 1, 1, 3, 4, 3, 3, 1, 1, 3,
    1, 1, 1, 0, 3, 0, 1, 1, 1, 5, 1, 1, 1, 3, 1, 1, 1, 1, 1, 3,
    1, 1, 1, 0, 3, 0, 1, 1, 1, 1, 1, 1, 1, 3, 1, 1, 1, 1, 1, 3,
    1, 1, 1, 0, 0, 0, 1, 1, 1, 1, 1, 1, 1, 3, 1, 1, 1, 1, 1, 3,
    1, 1, 1, 3, 3, 3, 1, 1, 1, 1, 1, 1, 1, 4, 1, 1, 1, 1, 1, 3,
    1, 1, 1, 1, 1, 1, 1, 1, 1, 1, 1, 1, 1, 3, 3, 3, 3, 3, 3, 3,
    1, 1, 1, 1, 1, 3, 3, 3, 3, 3, 3, 3, 1, 1, 1, 1, 3, 1, 1, 3,
    1, 1, 1, 1, 1, 1, 1, 1, 3, 4, 1, 1, 1, 1, 1, 1, 3, 1, 1, 3,
    1, 1, 1, 1, 1, 1, 1, 1, 3, 5, 1, 1, 1, 1, 1, 1, 1, 1, 1, 1,
    1, 1, 1, 1, 1, 1, 1, 1, 3, 1, 1, 1, 1, 1, 1, 1, 3, 1, 1, 1,
    1, 1, 1, 1, 1, 1, 1, 1, 3, 1, 1, 1, 1, 1, 1, 1, 3, 1, 1, 3,
    1, 1, 1, 1, 1, 1, 1, 1, 1, 1, 1, 3, 3, 3, 3, 1, 3, 3, 3, 3,
    1, 1, 1, 1, 1, 1, 1, 1, 1, 1, 1, 3, 1, 1, 1, 1, 1, 1, 1, 3,
    1, 1, 1, 1, 1, 1, 1, 1, 1, 1, 1, 3, 1, 1, 1, 1, 1, 1, 1, 3,
    1, 1, 1, 1, 1, 1, 1, 1, 1, 1, 1, 3, 1, 1, 1, 1, 1, 1, 1, 3,
    1, 1, 1, 1, 1, 1, 1, 1, 1, 1, 3, 3, 3, 3, 3, 3, 3, 3, 3, 3,
][
    1, 3, 3, 3, 3, 3, 3, 4, 3, 3, 3, 1, 3, 3, 3, 3, 3, 3, 3, 3,
    1, 1, 1, 1, 1, 1, 1, 1, 1, 1, 1, 1, 1, 1, 1, 1, 1, 1, 1, 3,
    1, 1, 1, 1, 1, 1, 2, 2, 2, 2, 2, 2, 2, 1, 1, 1, 1, 1, 1, 3,
    1, 1, 1, 0, 0, 0, 1, 1, 1, 1, 2, 1, 2, 1, 1, 1, 1, 1, 1, 3,
    1, 1, 1, 0, 0, 0, 4, 1, 1, 5, 1, 1, 1, 3, 4, 3, 3, 1, 1, 3,
    1, 1, 1, 0, 3, 0, 1, 1, 1, 5, 1, 1, 1, 3, 1, 1, 1, 1, 1, 3,
    1, 1, 1, 0, 3, 0, 1, 1, 1, 1, 1, 1, 1, 3, 1, 1, 1, 1, 1, 3,
    1, 1, 1, 0, 0, 0, 1, 1, 1, 1, 1, 1, 1, 3, 1, 1, 1, 1, 1, 3,
    1, 1, 1, 3, 3, 3, 1, 1, 1, 1, 1, 1, 1, 4, 1, 1, 1, 1, 1, 3,
    1, 1, 1, 1, 1, 1, 1, 1, 1, 1, 1, 1, 1, 3, 3, 3, 3, 3, 3, 3,
    1, 1, 1, 1, 1, 3, 3, 3, 3, 3, 3, 3, 1, 1, 1, 1, 3, 1, 1, 3,
    1, 1, 1, 1, 1, 1, 1, 1, 3, 4, 1, 1, 1, 1, 1, 1, 3, 1, 1, 3,
    1, 1, 1, 1, 1, 1, 1, 1, 3, 5, 1, 1, 1, 1, 1, 1, 1, 1, 1, 1,
    1, 1, 1, 1, 1, 1, 1, 1, 3, 1, 1, 1, 1, 1, 1, 1, 3, 1, 1, 1,
    1, 1, 1, 1, 1, 1, 1, 1, 3, 1, 1, 1, 1, 1, 1, 1, 3, 1, 1, 3,
    1, 1, 1, 1, 1, 1, 1, 1, 1, 1, 1, 3, 3, 3, 3, 1, 3, 3, 3, 3,
    1, 1, 1, 1, 1, 1, 1, 1, 1, 1, 1, 3, 1, 1, 1, 1, 1, 1, 1, 3,
    1, 1, 1, 1, 1, 1, 1, 1, 1, 1, 1, 3, 1, 1, 1, 1, 1, 1, 1, 3,
    1, 1, 1, 1, 1, 1, 1, 1, 1, 1, 1, 3, 1, 1, 1, 1, 1, 1, 1, 3,
    1, 1, 1, 1, 1, 1, 1, 1, 1, 1, 3, 3, 3, 3, 3, 3, 3, 3, 3, 3,
][
    1, 3, 3, 3, 3, 3, 3, 4, 3, 3, 3, 1, 3, 3, 3, 3, 3, 3, 3, 3,
    1, 1, 1, 1, 1, 1, 1, 1, 1, 1, 1, 1, 1, 1, 1, 1, 1, 1, 1, 3,
    1, 1, 1, 1, 1, 1, 2, 2, 2, 2, 2, 2, 2, 1, 1, 1, 1, 1, 1, 3,
    1, 1, 1, 0, 0, 0, 1, 1, 1, 1, 2, 1, 2, 1, 1, 1, 1, 1, 1, 3,
    1, 1, 1, 0, 0, 0, 4, 1, 1, 5, 1, 1, 1, 3, 4, 3, 3, 1, 1, 3,
    1, 1, 1, 0, 3, 0, 1, 1, 1, 5, 1, 1, 1, 3, 1, 1, 1, 1, 1, 3,
    1, 1, 1, 0, 3, 0, 1, 1, 1, 1, 1, 1, 1, 3, 1, 1, 1, 1, 1, 3,
    1, 1, 1, 0, 0, 0, 1, 1, 1, 1, 1, 1, 1, 3, 1, 1, 1, 1, 1, 3,
    1, 1, 1, 3, 3, 3, 1, 1, 1, 1, 1, 1, 1, 4, 1, 1, 1, 1, 1, 3,
    1, 1, 1, 1, 1, 1, 1, 1, 1, 1, 1, 1, 1, 3, 3, 3, 3, 3, 3, 3,
    1, 1, 1, 1, 1, 3, 3, 3, 3, 3, 3, 3, 1, 1, 1, 1, 3, 1, 1, 3,
    1, 1, 1, 1, 1, 1, 1, 1, 3, 4, 1, 1, 1, 1, 1, 1, 3, 1, 1, 3,
    1, 1, 1, 1, 1, 1, 1, 1, 3, 5, 1, 1, 1, 1, 1, 1, 1, 1, 1, 1,
    1, 1, 1, 1, 1, 1, 1, 1, 3, 1, 1, 1, 1, 1, 1, 1, 3, 1, 1, 1,
    1, 1, 1, 1, 1, 1, 1, 1, 3, 1, 1, 1, 1, 1, 1, 1, 3, 1, 1, 3,
    1, 1, 1, 1, 1, 1, 1, 1, 1, 1, 1, 3, 3, 3, 3, 1, 3, 3, 3, 3,
    1, 1, 1, 1, 1, 1, 1, 1, 1, 1, 1, 3, 1, 1, 1, 1, 1, 1, 1, 3,
    1, 1, 1, 1, 1, 1, 1, 1, 1, 1, 1, 3, 1, 1, 1, 1, 1, 1, 1, 3,
    1, 1, 1, 1, 1, 1, 1, 1, 1, 1, 1, 3, 1, 1, 1, 1, 1, 1, 1, 3,
    1, 1, 1, 1, 1, 1, 1, 1, 1, 1, 3, 3, 3, 3, 3, 3, 3, 3, 3, 3,
][
    1, 3, 3, 3, 3, 3, 3, 4, 3, 3, 3, 1, 3, 3, 3, 3, 3, 3, 3, 3,
    1, 1, 1, 1, 1, 1, 1, 1, 1, 1, 1, 1, 1, 1, 1, 1, 1, 1, 1, 3,
    1, 1, 1, 1, 1, 1, 2, 2, 2, 2, 2, 2, 2, 1, 1, 1, 1, 1, 1, 3,
    1, 1, 1, 0, 0, 0, 1, 1, 1, 1, 2, 1, 2, 1, 1, 1, 1, 1, 1, 3,
    1, 1, 1, 0, 0, 0, 4, 1, 1, 5, 1, 1, 1, 3, 4, 3, 3, 1, 1, 3,
    1, 1, 1, 0, 3, 0, 1, 1, 1, 5, 1, 1, 1, 3, 1, 1, 1, 1, 1, 3,
    1, 1, 1, 0, 3, 0, 1, 1, 1, 1, 1, 1, 1, 3, 1, 1, 1, 1, 1, 3,
    1, 1, 1, 0, 0, 0, 1, 1, 1, 1, 1, 1, 1, 3, 1, 1, 1, 1, 1, 3,
    1, 1, 1, 3, 3, 3, 1, 1, 1, 1, 1, 1, 1, 4, 1, 1, 1, 1, 1, 3,
    1, 1, 1, 1, 1, 1, 1, 1, 1, 1, 1, 1, 1, 3, 3, 3, 3, 3, 3, 3,
    1, 1, 1, 1, 1, 3, 3, 3, 3, 3, 3, 3, 1, 1, 1, 1, 3, 1, 1, 3,
    1, 1, 1, 1, 1, 1, 1, 1, 3, 4, 1, 1, 1, 1, 1, 1, 3, 1, 1, 3,
    1, 1, 1, 1, 1, 1, 1, 1, 3, 5, 1, 1, 1, 1, 1, 1, 1, 1, 1, 1,
    1, 1, 1, 1, 1, 1, 1, 1, 3, 1, 1, 1, 1, 1, 1, 1, 3, 1, 1, 1,
    1, 1, 1, 1, 1, 1, 1, 1, 3, 1, 1, 1, 1, 1, 1, 1, 3, 1, 1, 3,
    1, 1, 1, 1, 1, 1, 1, 1, 1, 1, 1, 3, 3, 3, 3, 1, 3, 3, 3, 3,
    1, 1, 1, 1, 1, 1, 1, 1, 1, 1, 1, 3, 1, 1, 1, 1, 1, 1, 1, 3,
    1, 1, 1, 1, 1, 1, 1, 1, 1, 1, 1, 3, 1, 1, 1, 1, 1, 1, 1, 3,
    1, 1, 1, 1, 1, 1, 1, 1, 1, 1, 1, 3, 1, 1, 1, 1, 1, 1, 1, 3,
    1, 1, 1, 1, 1, 1, 1, 1, 1, 1, 3, 3, 3, 3, 3, 3, 3, 3, 3, 3,
][
    1, 3, 3, 3, 3, 3, 3, 4, 3, 3, 3, 1, 3, 3, 3, 3, 3, 3, 3, 3,
    1, 1, 1, 1, 1, 1, 1, 1, 1, 1, 1, 1, 1, 1, 1, 1, 1, 1, 1, 3,
    1, 1, 1, 1, 1, 1, 2, 2, 2, 2, 2, 2, 2, 1, 1, 1, 1, 1, 1, 3,
    1, 1, 1, 0, 0, 0, 1, 1, 1, 1, 2, 1, 2, 1, 1, 1, 1, 1, 1, 3,
    1, 1, 1, 0, 0, 0, 4, 1, 1, 5, 1, 1, 1, 3, 4, 3, 3, 1, 1, 3,
    1, 1, 1, 0, 3, 0, 1, 1, 1, 5, 1, 1, 1, 3, 1, 1, 1, 1, 1, 3,
    1, 1, 1, 0, 3, 0, 1, 1, 1, 1, 1, 1, 1, 3, 1, 1, 1, 1, 1, 3,
    1, 1, 1, 0, 0, 0, 1, 1, 1, 1, 1, 1, 1, 3, 1, 1, 1, 1, 1, 3,
    1, 1, 1, 3, 3, 3, 1, 1, 1, 1, 1, 1, 1, 4, 1, 1, 1, 1, 1, 3,
    1, 1, 1, 1, 1, 1, 1, 1, 1, 1, 1, 1, 1, 3, 3, 3, 3, 3, 3, 3,
    1, 1, 1, 1, 1, 3, 3, 3, 3, 3, 3, 3, 1, 1, 1, 1, 3, 1, 1, 3,
    1, 1, 1, 1, 1, 1, 1, 1, 3, 4, 1, 1, 1, 1, 1, 1, 3, 1, 1, 3,
    1, 1, 1, 1, 1, 1, 1, 1, 3, 5, 1, 1, 1, 1, 1, 1, 1, 1, 1, 1,
    1, 1, 1, 1, 1, 1, 1, 1, 3, 1, 1, 1, 1, 1, 1, 1, 3, 1, 1, 1,
    1, 1, 1, 1, 1, 1, 1, 1, 3, 1, 1, 1, 1, 1, 1, 1, 3, 1, 1, 3,
    1, 1, 1, 1, 1, 1, 1, 1, 1, 1, 1, 3, 3, 3, 3, 1, 3, 3, 3, 3,
    1, 1, 1, 1, 1, 1, 1, 1, 1, 1, 1, 3, 1, 1, 1, 1, 1, 1, 1, 3,
    1, 1, 1, 1, 1, 1, 1, 1, 1, 1, 1, 3, 1, 1, 1, 1, 1, 1, 1, 3,
    1, 1, 1, 1, 1, 1, 1, 1, 1, 1, 1, 3, 1, 1, 1, 1, 1, 1, 1, 3,
    1, 1, 1, 1, 1, 1, 1, 1, 1, 1, 3, 3, 3, 3, 3, 3, 3, 3, 3, 3,
][
    1, 3, 3, 3, 3, 3, 3, 4, 3, 3, 3, 1, 3, 3, 3, 3, 3, 3, 3, 3,
    1, 1, 1, 1, 1, 1, 1, 1, 1, 1, 1, 1, 1, 1, 1, 1, 1, 1, 1, 3,
    1, 1, 1, 1, 1, 1, 2, 2, 2, 2, 2, 2, 2, 1, 1, 1, 1, 1, 1, 3,
    1, 1, 1, 0, 0, 0, 1, 1, 1, 1, 2, 1, 2, 1, 1, 1, 1, 1, 1, 3,
    1, 1, 1, 0, 0, 0, 4, 1, 1, 5, 1, 1, 1, 3, 4, 3, 3, 1, 1, 3,
    1, 1, 1, 0, 3, 0, 1, 1, 1, 5, 1, 1, 1, 3, 1, 1, 1, 1, 1, 3,
    1, 1, 1, 0, 3, 0, 1, 1, 1, 1, 1, 1, 1, 3, 1, 1, 1, 1, 1, 3,
    1, 1, 1, 0, 0, 0, 1, 1, 1, 1, 1, 1, 1, 3, 1, 1, 1, 1, 1, 3,
    1, 1, 1, 3, 3, 3, 1, 1, 1, 1, 1, 1, 1, 4, 1, 1, 1, 1, 1, 3,
    1, 1, 1, 1, 1, 1, 1, 1, 1, 1, 1, 1, 1, 3, 3, 3, 3, 3, 3, 3,
    1, 1, 1, 1, 1, 3, 3, 3, 3, 3, 3, 3, 1, 1, 1, 1, 3, 1, 1, 3,
    1, 1, 1, 1, 1, 1, 1, 1, 3, 4, 1, 1, 1, 1, 1, 1, 3, 1, 1, 3,
    1, 1, 1, 1, 1, 1, 1, 1, 3, 5, 1, 1, 1, 1, 1, 1, 1, 1, 1, 1,
    1, 1, 1, 1, 1, 1, 1, 1, 3, 1, 1, 1, 1, 1, 1, 1, 3, 1, 1, 1,
    1, 1, 1, 1, 1, 1, 1, 1, 3, 1, 1, 1, 1, 1, 1, 1, 3, 1, 1, 3,
    1, 1, 1, 1, 1, 1, 1, 1, 1, 1, 1, 3, 3, 3, 3, 1, 3, 3, 3, 3,
    1, 1, 1, 1, 1, 1, 1, 1, 1, 1, 1, 3, 1, 1, 1, 1, 1, 1, 1, 3,
    1, 1, 1, 1, 1, 1, 1, 1, 1, 1, 1, 3, 1, 1, 1, 1, 1, 1, 1, 3,
    1, 1, 1, 1, 1, 1, 1, 1, 1, 1, 1, 3, 1, 1, 1, 1, 1, 1, 1, 3,
    1, 1, 1, 1, 1, 1, 1, 1, 1, 1, 3, 3, 3, 3, 3, 3, 3, 3, 3, 3,
][
    1, 3, 3, 3, 3, 3, 3, 4, 3, 3, 3, 1, 3, 3, 3, 3, 3, 3, 3, 3,
    1, 1, 1, 1, 1, 1, 1, 1, 1, 1, 1, 1, 1, 1, 1, 1, 1, 1, 1, 3,
    1, 1, 1, 1, 1, 1, 2, 2, 2, 2, 2, 2, 2, 1, 1, 1, 1, 1, 1, 3,
    1, 1, 1, 0, 0, 0, 1, 1, 1, 1, 2, 1, 2, 1, 1, 1, 1, 1, 1, 3,
    1, 1, 1, 0, 0, 0, 4, 1, 1, 5, 1, 1, 1, 3, 4, 3, 3, 1, 1, 3,
    1, 1, 1, 0, 3, 0, 1, 1, 1, 5, 1, 1, 1, 3, 1, 1, 1, 1, 1, 3,
    1, 1, 1, 0, 3, 0, 1, 1, 1, 1, 1, 1, 1, 3, 1, 1, 1, 1, 1, 3,
    1, 1, 1, 0, 0, 0, 1, 1, 1, 1, 1, 1, 1, 3, 1, 1, 1, 1, 1, 3,
    1, 1, 1, 3, 3, 3, 1, 1, 1, 1, 1, 1, 1, 4, 1, 1, 1, 1, 1, 3,
    1, 1, 1, 1, 1, 1, 1, 1, 1, 1, 1, 1, 1, 3, 3, 3, 3, 3, 3, 3,
    1, 1, 1, 1, 1, 3, 3, 3, 3, 3, 3, 3, 1, 1, 1, 1, 3, 1, 1, 3,
    1, 1, 1, 1, 1, 1, 1, 1, 3, 4, 1, 1, 1, 1, 1, 1, 3, 1, 1, 3,
    1, 1, 1, 1, 1, 1, 1, 1, 3, 5, 1, 1, 1, 1, 1, 1, 1, 1, 1, 1,
    1, 1, 1, 1, 1, 1, 1, 1, 3, 1, 1, 1, 1, 1, 1, 1, 3, 1, 1, 1,
    1, 1, 1, 1, 1, 1, 1, 1, 3, 1, 1, 1, 1, 1, 1, 1, 3, 1, 1, 3,
    1, 1, 1, 1, 1, 1, 1, 1, 1, 1, 1, 3, 3, 3, 3, 1, 3, 3, 3, 3,
    1, 1, 1, 1, 1, 1, 1, 1, 1, 1, 1, 3, 1, 1, 1, 1, 1, 1, 1, 3,
    1, 1, 1, 1, 1, 1, 1, 1, 1, 1, 1, 3, 1, 1, 1, 1, 1, 1, 1, 3,
    1, 1, 1, 1, 1, 1, 1, 1, 1, 1, 1, 3, 1, 1, 1, 1, 1, 1, 1, 3,
    1, 1, 1, 1, 1, 1, 1, 1, 1, 1, 3, 3, 3, 3, 3, 3, 3, 3, 3, 3,
]
